NO ./textures/walls/06.png
SO ./textures/walls/82.png
WE ./textures/walls/72.png
EA ./textures/walls/29.png
F 25,25,112
C 225,30,0
11111111111111111111111111111111111111111111111111
10000000001100000000000000000000000000000000000001
10110000011100000000000000000000000000000000000001
10010000000000000000000000000000000000000000000001
11111111101100000111000000000000000000000000000001111
100000000011000001110111100000000000000000000000001111
111101111111110111000000100000000000000000000000000001
111101111111110111010100100000000000000000000000000001
110000001101010111000000100000000000000000000000000001
100000000000000011000000000000000000000000000000000001
100000000000000000010100100000000000000000000000000001
100000000000000000010100100000000000000000000000000001
1000000000000N0000010100100000000000000000000000000001
100000000000000000010100100000000000000000000000000001
100000000000000000010100100000000000000000000000000001
100000000000000000010100100000000000000000000000000001
100000000000000000010100100000000000000000000000000001
1100 0001110101011111011100000000000000000000000000001
11110111 1110101 1011110100000000000000000000000000001
100000000000000000000000000000000000000000000000000001
100000000000000000000000000000000000000000000000000001
100000000000000000000000000000000000000000000000000001
100000000000000000000000000000000000000000000000000001
100000000011000000000000000000000000000000000000011111
10110000011100000000000000000000000000000000000001
10010000000000000000000000000000000000000000000001
11111111101100000111000000000000000000000000000001111
100000000011000001110111100000000000000000000000001111
111101111111110111000000100000000000000000000000000001
111101111111110111010100100000000000000000000000000001
110000001101010111000000100000000000000000000000000001
111111111111111111111111111111111111111111111111111111