NO ./textures/walls/08.png
SO ./textures/walls/12.png
WE ./textures/walls/30.png
EA ./textures/walls/39.png
F 25,25,112
C 225,30,0
1111111111111111111111111
1000000000110000000000001
1011000001110000000000001
1001000000000000000000001
1111111110110000011100001
100000000011000001110111111111
111101111111110111000000100011
111101111111110111010100100011
110000001101010111000000100011
100000000000000011000000000011
100000000000000000010100100011
100000000000000000010100100011
1000000000000NE000010100100011
100000000000000000010100100011
100000000000000000010100100011
100000000000000000010100100011
100000000000000000010100100011
1100 0001110101011111011100011
11110111 1110101 1011110100011
11111111 1111111 1111111111111